
NO ./textures/simonkraft/bookshelf.xpm
SO ./textures/simonkraft/bookshelf_01.xpm
WE ./textures/simonkraft/bookshelf_02.xpm
EA ./textures/simonkraft/bookshelf_03.xpm

F 139,99,58
C 171,154,137

1111111111111111111
1000000000000000001
11000100N0010000011
1000000000000000001
1000000000000000001
1111111110111111111
        1B1
        101
1111111110111111111
1000000100000000001111111111111111111111111111111111111111111111111111111111111111111111
100000010000000000B000000000000000000000000000000000000000000000000000000000000000000001
1000000100000000001111111111111111111111111111111111111111111111111111111111111111111101
1000000100000000001                                                                  101
100000011111111B111                                                                  101
1000000100000000001                                                                  101
1000000B00000000001                                                                  101
1000000100000000001                                                                  101
1111111111111111111                                                                  101
                                                                                     101
                                                                                     101
                                                                                     101
                                                                                     101
                                                                                     101
                                                                                     101
                                                                                     101
                                                                                     101
                                                                                     101
                                                                                     101
                                                                                     101
                                                                                     101
                                                                                     101
                                                                                     101
                                                                                     101
                                                                        11111111111111B111111111111111
                                                                        100000000000000000000000000001
                                                                        100000000000000000000000000001
                                                                        100000000000000000000000000001
                                                                        100000000000000000000000000001
                                                                        100000000000000000000000000001
                                                                        100000000000000000000000000001
                                                                        100000000000000000000000000001
                                                                        100000000000000000000000000001
                                                                        100000000000000000000000000001
                                                                        100000000000000000000000000001
                                                                        100000000000000000000000000001
                                                                        100000000000000000000000000001
                                                                        111111111111111111111111111111