WE     textures/wolfenstein/grey_stone.xpm
NO      textures/wolfenstein/purple_stone.xpm



SO textures/wolfenstein/red_brick.xpm

F      17,    38,     64

EA textures/wolfenstein/wood.xpm



C 218, 234, 235

1111111111111111111111111
1BS0110001100010010001001
1000110100010010111110001
1000000101000110110000001
1011100100101110011001001
1111111111111111111111111
