NO ./textures/walls/orangeWall.xpm
SO ./textures/walls/grayWall.xpm
EA ./textures/walls/greenWall.xpm
WE ./textures/walls/redWall.xpm

F         103,61,38
C         121,190,219


        11111111111111111111111111
        1000000000000000000000011
        11000000000000000000000111
        11000000000000000000000111
        10000000000000000000000001
        10000000000000000000000001
        10000000000000000000000001
1111111110000000000000000000000001
100000000000000000000000000000011111
11110111100000000000000000000001
11110111100000000000000000000001
11000000100000000000000000000001
10000000000000000S00000000000001
10000000000000000000000000000001
10000000000000000000000000000001
10000000000000000000000000000001
11000001110101011111011111000111
11110111 1110101 1011111010001
11111111 1111111 1111111111111
