NO ./textures/walls/orangeWall.xpm
SO ./textures/walls/grayWall.xpm
EA ./textures/walls/greenWall.xpm
WE ./textures/walls/redWall.xpm

F         255  , 30, 255
C         255   ,  30      ,   255


        1111111111111111111111111
        100000000001000000N000011
        1111101111111111111111111
        1111101111111111111111111
        1000000000110000000000001
        1011000001110000000000001
        1001000000000000000000001
111111111011000001110000000000001
10000000000000000000000000011111111
1111011110000000000000000000001
1111011110000000000000000000001
1100000010000000000001000000001
1000000000000000000000000000001
1000000000000000000000000000001
1000000000000000000000000000001
1000000000000000000000000000001
1100000111010101111101111000111
11110111 1110101 101111010001
11111111 1111111 111111111111
